##########
#        #
#   ##   #
#   #    #
    #    #
##### ####
#        #
#        #
#        #
##########

HealingPotion,8,4
Treasure,5,8
Door,0,4,room0,9,4